##################################
#                               ##
#                              # #
#       ##                    #  #
###  ####       #####     ####   #
#                                #
#                   #            #
#    ####     #        ####      #
#             #####              #
#                                #
#       #####                    #
#            #                   #
#             #                  #
#              #           #######
#          #####          #      #
#                         #      #
#   #                   #        #
### #                            #
#                                #
#       #           ####         #
#        #                       #
#         #                 ######
#          #            ##       #
#         #       #####          #
### ######                    #  #
#                         ##     #
#      #     #                   #
#       #####        ##          #
#                                #
##################################